20 20
####################
#...#........X#K...#
#...#.############.#
#.#.#.#K#........#.#
#.#...#.#.########.#
#.#####.#.#K....G..#
#...G.#.G.#.#####..#
#####.#.#.#.#.##...#
#...#.#.#...#....#.#
#.###.#.##########.#
#.G.......#.....G..#
#.###G#...#.#####..#
#.###.#####.#...##G#
#...#.#...#.#.#.##.#
###.#...#.#.#K#.##.#
#X#.#####.#.###.#.K#
#.#.#.G...#.....#..#
#.###.#.#.###.#.####
#.....#.#...#.#....#
####################
