20 20
##.#######.#########
#....#...........X##
#....#..#########G##
#....#....#G........
###G###G############
....#........K.....#
#.#.#.............##
#.#.#########G######
#.#...G.......######
##########G#########
#...................
#...................
#K..................
#.................##
#.................##
#......K.....X....##
#.................##
#.................##
#.................##
#######.############
#######.############
