20 20
####################
#..........G.....X##
#..##############G##
#..........G.......#
###G###G############
....#........K.....#
#.#.#.............##
#.#.#########G######
#.#...G.......######
##########G#########
#..................#
#.............K....#
################...#
#..........##..#..##
######.#..##...#.K##
#...#..K..G..X.#..##
#...#..#..######..##
#...#..#..#..#....##
#......#...#...#..##
####################
####################
