20 20
####################
#......X..#.....#..#
#..#.#..#######.#..#
#..#.#.##.......#..#
#.##.#.#..#####.#..#
#....#........#.#..#
#..#.########......#
#..#.#........#..#.#
#..#..........#..#.#
##########.#####.###
#..#.#......#..#...#
#....#.#...........#
#..#X#.########.####
#.####.#.........#.#
#.#..#######.....#.#
#.#..#.....#.....#.#
#.#..............#.#
#.#########........#
#......#..#..#####.#
#..................#
####################
