50 50
##################################################
#..####....####....####....####....####....####..#
#..####....####....####....####....####....####..#
#..####....####....####....####....####....####..#
#..####....####....####....####....####....####..#
##......##......##......##......##......##....##.#
##..##..##..##..##..##..##..##..##..##..##.##.##.#
##..##..##..##..##..##..##..##..##..##..##.##.##.#
##......##......##......##......##......##....##.#
#..####....####....####....####....####....####..#
#..####....####....####....####....####....####..#
#..####....####....####....####....####....####..#
#..####....####....####....####....####....####..#
##......##......##......##......##......##....##.#
##..##..##..##..##..##..##..##..##..##..##.##.##.#
##..##..##..##..##..##..##..##..##..##..##.##.##.#
##......##......##......##......##......##....##.#
#..####....####....####....####....####....####..#
#..####....####....####....####....####....####..#
#..####....####....####....####....####....####..#
##......##......##......##......##......##....##.#
##..##..##..##..##..##..##..##..##..##..##.##.##.#
##..##..##..##..##..##..##..##..##..##..##.##.##.#
##......##......##......##......##......##....##.#
#..####....####....####....####....####....####..#
#..####....####....####....####....####....####..#
#..####....####....####....####....####....####..#
#..####....####....####....####....####....####..#
##......##......##......##......##......##....##.#
##..##..##..##..##..##..##..##..##..##..##.##.##.#
##..##..##..##..##..##..##..##..##..##..##.##.##.#
##......##......##......##......##......##....##.#
#..####....####....####....####....####....####..#
#..####....####....####....####....####....####..#
#..####....####....####....####....####....####..#
##......##......##......##......##......##....##.#
##..##..##..##..##..##..##..##..##..##..##.##.##.#
##..##..##..##..##..##..##..##..##..##..##.##.##.#
##......##......##......##......##......##....##.#
#..####....####....####....####....####....####..#
#..####....####....####....####....####....####..#
#..####....####....####....####....####....####..#
##......##......##......##......##......##....##.#
##..##..##..##..##..##..##..##..##..##..##.##.##.#
##..##..##..##..##..##..##..##..##..##..##.##.##.#
##......##......##......##......##......##....##.#
#..####....####....####....####....####....####..#
#..####....####....####....####....####....####..#
#..####....####....####....####....####....####..#
##################################################
